     NO      /home/cgoh/sgoinfre/cub3d/textures/Brick.xpm


   SO     /home/cgoh/sgoinfre/cub3d/textures/Metal.xpm


    WE     /home/cgoh/sgoinfre/cub3d/textures/Stone.xpm


        EA       /home/cgoh/sgoinfre/cub3d/textures/Wood.xpm






F    200,100,100   



    C    132,255,222   




        0111111111111111111111111
        1000000000110000000000001
        101100000111000000E000D01
        100100000000D000000000001
111111111011000001110000000000001
10000000001100000111D111111111111
11110111111111011100000010001
11110111111111011101010010001
110000001101010111000000D0011
1000000000000000110000010001
10000000000000001101010010011
1100000111010101111101111000111
11110111 1110101 101111010001
11111111 1111111 111111111111
