     NO      ./textures/walls/Brick.xpm


   SO     ./textures/walls/Brick.xpm


    WE     ./textures/walls/Brick.xpm


        EA       ./textures/walls/Brick.xpm






F    0,0,0



    C    0,0,0   




        1111111111111111111111111
        10000000001100000000000M1
        1011000001110000E0000D001
        10010000000D0000000000001
1111111110110000011100000000000M1
10000000001100000111D111111111111
11110111111111011100000010001
11110111111111011101010010001
110000001101010111000000D0011
1000000000000000110000010001
10000000000000001101010010011
1100000111010101111101111000111
11110111 1110101 101111010001
11111111 1111111 111111111111
