NO ./textures/Brick.xpm
SO ./textures/Brick.xpm
WE ./textures/Brick.xpm
EA ./textures/Brick.xpm

F 255,255,0
C 0,42,55

111111111111
100000000001
101111111101
101111111101
101111111101
1000000S0001
111111111111
