NO ./textures/walls/Brick.xpm

SO ./textures/walls/Metal.xpm

WE ./textures/walls/Stone.xpm

F 255,255,0

C 0,42,55

EA ./textures/walls/Wood.xpm

1111111111111
1111111111111
110N000000011
1111111111111
1111111111111
