NO ./textures/Brick.xpm
SO ./textures/Brick.xpm
EA ./textures/Brick.xpm
WE ./textures/Brick.xpm
C 123,52,21
F 99,101,234

11111111111111111111111111111111111111111111111111
10100000010101000000001001000000000100000100001001
10000110000000001001000010001000101001000000100001
10101001000001100110010100010010100000101111011101
10010001000010010000011000100100110001000000000011
10011001000100001010000001000100001110000110001001
10100010000101001100010001010111000000011001111101
10110100110001010000111010001000111000000000001001
10000100001010010010010100010010000111111011100001
10010101100100010101010001100111110000000100000011
10101000010010000100001000010010001100010101000101
10100111001011000000100001001000100000100010001001
10010000100000111111001101010000001011001001010001
11010110010110000000110001001001001000000101011101
10010001010001000110000000101010101010101001000001
10010001000100111001110011001010000100101010001111
11000010011010000100000000010001111001001000010001
10101001000011110010011100100010000010010100100101
10001000011000001001100010100100100101100010000101
10010100100111100100001001010100011000001001101001
10000010101000000110111100010001000010010100010001
11110010001001010001001010101001011001100001010011
10001010110010100001000010000000100110001010100001
11001011000100001100011000100010101000100100000101
10001000010000010001000100101000001010000101000011
10100111000100010000010100100100110001000D00111001
1010100010010010110110001010100100010D000110000101
10000000101000000010001001001010010101001001110001
11001111000010010010101000100010100101000100001001
100100000000111000101001100011001000S1000000001001
10010111011100001000101000010000011000001110010001
10010000100001110001001010010001100111010001100101
10101110001110000010010001001010000000100100010001
10000001000000101100010100100010101110010010001001
10011001001001000011001001001010010001001001001001
11100101101000001000010010000100010100101000000001
10000100001001001011100101110010010101001010010001
10100110001110000100000100001001010001000100100101
10101000100000100100100100100001001010110010101011
10100010110111001000000010011110001000000000101001
10110000001000100101001001000001000100011100001001
10001000001001110100010000101000110000100011101001
10100111000000100010101111000110001011001000000101
10100000101110000010000000001000101000101100010001
10010010010001001000100001010001001110000010000101
11010010010100100111001000100100000001011000101001
10011101000100010000010001000111111101000101000001
10100001111001101111011110010000000001100000000101
10000100000100000000000000100000010000010001001001
11111111111111111111111111111111111111111111111111
