NO ./textures/walls/Brick.xpm
SO ./textures/walls/Metal.xpm
WE ./textures/walls/Stone.xpm
EA ./textures/walls/Wood.xpm

F 255,255,0
C 0,42,55

11111111111
100N0000001
111111U1111
